-2,-1,0,1,2,Total
0,3,2,23,4,32
0,1,9,17,3,30
0,5,5,9,4,23
0,3,8,11,5,27
0,1,12,12,5,30
1,2,6,8,4,21
1,1,4,16,5,27
2,3,12,11,2,30
0,2,7,16,3,28
0,2,10,16,2,30
1,1,13,12,3,30
0,1,18,8,3,30
1,2,13,11,1,28
0,3,8,9,3,23
1,2,8,12,3,26
0,2,8,9,2,21
0,3,11,15,3,32
0,2,11,8,7,28
0,1,13,14,2,30
1,1,7,9,3,21
1,2,9,12,3,27
0,3,3,14,3,23
1,2,14,8,2,27
1,4,9,14,2,30
0,2,12,13,3,30
0,0,5,23,4,32
0,5,8,11,6,30
0,1,14,11,2,28
0,3,10,14,3,30
0,0,11,15,2,28
0,1,11,6,3,21
0,4,8,8,1,21
1,4,7,14,4,30
0,1,6,11,3,21
2,5,11,6,3,27
1,5,16,8,0,30
0,3,16,11,2,32
0,1,11,10,6,28
1,5,10,8,6,30
0,3,7,13,7,30
1,4,8,13,6,32
0,1,13,10,3,27
2,1,9,13,3,28
1,3,8,16,2,30
1,3,5,16,3,28
1,2,4,16,5,28
0,1,6,17,6,30
0,3,5,17,5,30
0,1,7,12,3,23
0,1,12,14,3,30
2,2,9,11,6,30
2,4,6,9,5,26
0,2,8,12,6,28
0,2,7,17,6,32
0,4,6,10,1,21
0,5,7,13,5,30
0,3,6,16,5,30
1,4,6,16,5,32
1,2,8,13,3,27
0,7,6,14,3,30
0,4,4,12,3,23
0,1,6,16,5,28
0,1,13,14,4,32
0,1,3,13,9,26
1,5,2,14,5,27
1,2,0,13,10,26
0,2,3,12,6,23
1,1,7,14,5,28
1,1,5,14,5,26
1,2,15,11,3,32
0,4,3,15,8,30
1,1,2,18,5,27
0,4,7,16,3,30
0,2,6,13,7,28
0,1,4,18,7,30
0,3,7,15,2,27
0,4,16,9,1,30
1,2,4,17,4,28
1,0,3,21,3,28
0,1,2,13,5,21
1,5,1,15,4,26
1,6,3,12,1,23
0,4,1,14,7,26
0,3,3,17,5,28
2,5,11,7,3,28
0,2,3,16,7,28
1,1,1,16,13,32
0,1,7,17,5,30
0,3,2,13,8,26
0,1,4,18,5,28
0,1,4,22,3,30
0,2,4,11,4,21
1,3,3,16,7,30
0,1,7,14,4,26
1,3,4,13,2,23
0,4,6,9,2,21
1,7,4,8,3,23
2,5,8,10,3,28
0,1,2,14,6,23
0,2,6,12,6,26